1111111111111111111111111
10000C0100000000000000001
10000001000000E0000000001
1000000100000000000000001
1000000100000000000000001
10000000000000000000000P1
1111111111111111111111111