1111111111111
10000000000C1
1000011111101
1P0001E000001
1111111111111